Whoops.

You agreed to be an understudy for FILL_IN because they have, literally, never been sick a day in their life.  And, you suppose, they still haven't.  And normally, getting trampled by a rogue capybara still wouldn't dissuade them from performing in FILL_IN as FILL_IN, literally their favorite part in FILL_IN's entire oeuvre.  But FILL_IN the director apparently didn't think pushing a comatose patient on stage would do much for the audience's enjoyment, so here you are.

And normally, you'd be fine with this; you've understudied a lot.  But FILL_IN?  There was no way they weren't going to be here.  So you... never actually learned your part.  Or read the play, really.

But!  You have excellent improv skills, a keen sense of story and theater, a (generally) excellent cast to work with, and an uncanny ability to fully inhabit the characters you portray.  You got this.

The Understudy: name_of_play
An Interactive Winging It by someone, from a seed by Lucian Smith
Release 1 / Serial number 230105 / Inform 7 build 6M62 (I6/v6.33 lib 6/12N) SD
Remember:  you can ENTER CHARACTER or BREAK CHARACTER at any time.

stage1
You can see a box (empty) here.

It's a stage.

>x character
You see nothing special about character.

>enter character
You enter the character of FILL_THIS_IN and become them more fully.

>actions
Actions listing on.

>enter character
[entering character]
You enter the character of FILL_THIS_IN and become them more fully.
[entering character - failed]

>look
[looking]
stage1
[looking - succeeded]

* * *

>actions
Actions listing on.

* * *

>enter character
[entering character]
You enter the character of FILL_THIS_IN and become them more fully.
[entering character - failed]

>scenes
Scene 'Entire Game' playing (for 1 mins now)
Scene 'Being OOC' ended
Scene 'Being IC' playing (for 1 mins now)
(Scene monitoring now switched on. Type "scenes off" to switch it off again.)

>x room
You can't see any such thing.

>l
[looking]
stage1
A lovely pasture.
[looking - succeeded]

* * *

>enter character
You enter the character of FILL_THIS_IN and become them more fully.

stage1
You can see a box (empty) here.

A lovely pasture.

>l
stage1
You can see a box (empty) here.

A lovely pasture.

>actions
Actions listing on.

>exit character
I only understood you as far as wanting to exit.

>break character
[attacking character]
With a long blink, you extricate yourself mentally from FILL_THIS_IN so you can look at your actual surroundings a bit better.

[(1) looking]
stage1
You can see a box (empty) here.

It's a stage.

[(1) looking - succeeded]

[attacking character - failed]

>scenes
Scene 'Entire Game' playing (for 3 mins now)
Scene 'OOC' playing (for 1 mins now)
Scene 'IC' ended
(Scene monitoring now switched on. Type "scenes off" to switch it off again.)

>l
[looking]
stage1
You can see a box (empty) here.

It's a stage.

[looking - succeeded]

>x character
[examining character]
The character you're portraying is FILL_THIS_IN.  To really embody that character for the audience, type ENTER CHARACTER.  To return to your acting self, you can BREAK CHARACTER or EXIT CHARACTER.

[examining character - succeeded]

>enter box
[entering the box]
You get into the box.

[entering the box - succeeded]

>exit box
I only understood you as far as wanting to exit.

>exit
[exiting]
You get out of the box.

stage1
You can see a box (empty) here.

It's a stage.

[exiting - succeeded]

>enter box
[entering the box]
You get into the box.

[entering the box - succeeded]

>get out of box
I only understood you as far as wanting to get outside.

* * *

>exit character
You're already out of character.

>enter character
You enter the character of FILL_THIS_IN and become them more fully.

stage1
You can see a box (empty) here.

A lovely pasture.

>enter box
You get into the box.

>exit box
You get out of the box.

stage1
You can see a box (empty) here.

A lovely pasture.

>exit
But you aren't in anything at the moment.

>exit character
With a long blink, you extricate yourself mentally from FILL_THIS_IN so you can look at your actual surroundings a bit better.

stage1
You can see a box (empty) here.

It's a stage.

>x character
The character you're portraying is FILL_THIS_IN.  To really embody that character for the audience, type ENTER CHARACTER.  To return to your acting self, you can BREAK CHARACTER or EXIT CHARACTER.

>x me
The character you're portraying is FILL_THIS_IN.  To really embody that character for the audience, type ENTER CHARACTER.  To return to your acting self, you can BREAK CHARACTER or EXIT CHARACTER.

>enter character
You enter the character of FILL_THIS_IN and become them more fully.

stage1
You can see a box (empty) here.

A lovely pasture.

>x me
You are FILL_THIS_IN... though at some level, you still remember that you're just portraying them.  To return to your acting self, you can BREAK CHARACTER or EXIT CHARACTER.  To become FILL_THIS_IN again, you can ENTER CHARACTER.